#American words confused with British ones
#(c) 2014 Reza1615
#Licensed under LGPL
#The list includes mostly words from https://fa.wikipedia.org/w/index.php?title=ویکی‌پدیا:اشتباه‌یاب/فهرست.py
ابولفضل=ابوالفضل
اختاپوث=اختاپوس
ارتقاع=ارتقا
اصطرلاب=اسطرلاب
اطاق=اتاق
اطراق=اتراق
اطو=اتو
اعطلا=اعتلا
اعلم‌تر=داناتر
اغلاط=غلط‌ها
افسنطین=افسنتین
افضل‌تر=بهتر
التفاط=التفات
انظباط=انضباط
آروق=آروغ
آزمایشات=آزمایش‌ها
آزمایشات=آزمایش‌ها
باباقوری=باباغوری
باجناق=باجناغ
بارگزار=بارگذار
بازرسین=بازرسان
باطلاق=باتلاق
بدیت=بدی
برخواست=برخاست
برخواستن=برخاستن
بلاخره=بالاخره
بلقور=بلغور
بنیانگزار=بنیانگذار
بنیان‌گزار=بنیان‌گذار
بی‌مهابا=بی‌محابا
پاتوغ=پاتوق
پاکات=پاکت‌ها
پرفسور=پروفسور
پزشگی=پزشکی
پنچ=پنج
پیشنهادات=پیشنهادها
پیشنهادات=پیشنهادها
ترجیه=ترجیح
تضاهر=تظاهر
تلوزیون=تلویزیون
توجیح=توجیه
توصعه=توسعه
توضیع=توزیع
جاناً=جانی
جواسیس=جاسوس‌ها
چهارماً=چهارم
چهارما=چهارم
حاظر=حاضر
حتی‌الامکان=حدالامکان
حظرات=حضرات
حظرت=حضرت
حظور=حضور
خابیدن=خوابیدن
خانند=خوانند
خردن=خوردن
خرشید=خورشید
خواستگاه=خاستگاه
خوانواده=خانواده
خوبیت=خوبی
خوبیت=خوبی
خوشنود=خشنود
داوطلبین=داوطلبان
داوطلبین=داوطلبان
دستورات=دستورها
دوماً=دوم
دوئیت=دوگانگی
رهبریت=رهبری
زباناً=زبانی
زبانا=زبانی
زنده‌گی=زندگی
ساتع=ساطع
سپاسگذار=سپاسگزار
سرلشگر=سرلشکر
سفارشاً=سفارشی
سفارشا=سفارشی
سفارشات=سفارش‌ها
سوماً=سوم
سوما=سوم
صحفه=صفحه
ضمینه=زمینه
طپش=تپش
طنبور=تنبور
ظبط=ضبط
علم‌شنگه=الم‌شنگه
فارق‌التحصیل=فارغ‌التحصیل
فرمایشات=فرمایش‌ها
فرمایشات=فرمایش‌ها
قائله=غائله
کوهستانات=کوهستان‌ها
کهکیلویه=کهگیلویه
گاهاً=گاهی
گاها=گاهی
گاها=گاهی
گرایشات=گرایش‌ها
گرایشات=گرایش‌ها
گزارشات=گزارش‌ها
گزارشات=گزارش‌ها
لحجه=لهجه
لشگر=لشکر
مبری=مبرا
متاصفانه=متأسفانه
متعصفانه=متأسفانه
مجالیس=مجلس‌ها
محصوب=محسوب
مذبور=مزبور
مرحم=مرهم
مرهمت=مرحمت
مزحک=مضحک
مطمعن=مطمئن
ملاحضه=ملاحظه
ملیارد=میلیارد
ملیون=میلیون
منیٔت=منی
منیت=منی
ناچاراً=به‌ناچار
ناچارا=به‌ناچار
نقطه‌نظر=دیدگاه
نمایشات=نمایش‌ها
وحله=وهله
ویرایشات=ویرایش‌ها
ویرایشات=ویرایش‌ها
ویژ‌ه‌گی=ویژگی
هاوی=حاوی
